R 1920 1080
SO ./textures/xpm/redbrick.xpm
NO ./textures/xpm/purplestone.xpm
EA ./textures/xpm/mossy.xpm
WE ./textures/xpm/wood.xpm

S ./textures/barrel.png
F 220,100,0
C 225,30,0

444444444444686444444444
400000000000606400000004
401234567800606400060604
400000000000606400005004
400000000000606400060604
400000000000606400000004
400000000000600000000004
400005550555606400000004
400005000005606400000004
400005500005606440444444
400005000005606660666661
4000055000000000000000N1
400005000005606666606661
400005500005606222202222
400005000005606200000002
400005550555606200000002
770077770777606205050502
700007000007606200000002
700000000007606200000002
700007000007606222202223
700007707077606300202003
700007707077606300000003
700007707077606300202003
777777181811646322222223
