R 1024 768
NO ./textures/xpm/greystone.xpm
WE ./textures/xpm/mossy.xpm
EA ./textures/xpm/bluestone.xpm
SO ./textures/xpm/colorstone.xpm

S ./textures/xpm/barrel.xpm
F 87,59,12
C 135,206,250

1111111111111111111
1000000002000000001
1000000000000000001
1000000000000000001
1000000000000000001
1000000000000000001
1000000000000000001
1000000110110000001
1000000100010000001
120000000N000000021
1000000100010000001
1000000110110000001
1000000000000000001
1000000000000000001
1000000000000000001
1000000000000000001
1000000000000000001
1000000002000000001
1111111111111111111
